############################################################
#       #    !e                #     #       !d  #         #
#  1    #                      #     &c           ##   ?   #
#       ######     ##&D#       #     #              #      #
#  !a   &b   ######     ########     #########       #     #
#       #                            #       #       #     #
#####&A#######                ###########     #     #      #
#        2   ####### ####     #         #      #    &e     #
#   !b       #   !c     #      #       #        #   #      #
############################################################